10 8
0 7
0 0
_________7
_*_______7
_____*___7
___*_____7
________*7
*________7
*________7
______*__7